{
  "name": "Entrance to Hades",
  "bkColor": "34",
  "borderColor": "02",
  "layout": [
    "A000000000000000",
    "A000000000000000",
    "A000001504550000",
    "A000001044430000",
    "A000001044540000",
    "A000001044400000",
    "A000001504550000",
    "A000000C0C300000",
    "A000000000000000",
    "A001010414150410",
    "A001451111041110",
    "A001111114041110",
    "A001311111041510",
    "A001010411041115",
    "A003030C330C330C",
    "A000000000000000"
  ],
  "graphicData": {
    "floor": "A3A01482500A412805",
    "wall": "63BBBB38BBBBBB83BB",
    "nasty": "32BF5C583028584830"
  },
  "adjoiningRoom": {
    "left": "0E",
    "right": "05",
    "above": false,
    "below": false
  },
   "guardians":{
      "vertical":[
         {
            "figures":[
               {
                  "attribute":"04",
                  "limits":{
                     "up":0,
                     "down":88
                  },
                  "speed":1,
                  "init":{
                     "x":16,
                     "y":48,
                     "direction":0,
                     "frame":0
                  }
               }
            ],
            "width":32,
            "height":64,
            "paintCorrections":{
               "x":0,
               "y":0
            },
            "frames":2,
            "directions":1,
            "sprite":[
              [
                "---#-#-#------##-#------#-#-#---",
                "--#-#-#-#-#####-######-#-#-#-#--",
                "---#-#-#-#-####--####-#-#-#-#---",
                "-#--#-#-#-#-#------#-#-#-#-#--#-",
                "--##-#-#-#-###----###-#-#-#-##--",
                "#---#-#-#-#-###--###-#-#-#-#---#",
                "-##-##-#-#-###----###-#-#-##-##-",
                "#--##--######--##--######--##--#",
                "-##-###-#-############-#-###-##-",
                "##-###-#-##---####---##-#-###-##",
                "--#-###--#--#--##--#--#--###-#--",
                "-#-##--##------##------##--##-#-",
                "-----#--#-----#--#-----#--#-----",
                "--#-#-####---##--##---####-#-#--",
                "---#--#-######----######-#--#---",
                "----##--######-##-######--##----",
                "--------######-##-######--------",
                "--------#-#########-####--------",
                "--------###-#-#-##-#-###--------",
                "--------#-#-#-#--#---#-#--------",
                "---------##-#---##-#-#----------",
                "---------#--#---#----#----------",
                "---------#-----------#----------",
                "---------#-------------#--------",
                "---------#-#--------------------",
                "-----------#--#-----#-#---------",
                "---------#----------##----------",
                "----------#-#-#---#---#---------",
                "-----------#-#--#-#-#-----------",
                "----------#-----#----#----------",
                "-----------#-#----#-#-----------",
                "-------------#-#--#-------------"
              ],
              [
                "---#-#-#------##-#------#-#-#---",
                "--#-#-#-#-#####-######-#-#-#-#--",
                "---#-#-#-#-####--####-#-#-#-#---",
                "-#--#-#-#-#-#------#-#-#-#-#--#-",
                "--##-#-#-#-###----###-#-#-#-##--",
                "#---#-#-#-#-###--###-#-#-#-#---#",
                "-##-##-#-#-###----###-#-#-##-##-",
                "#--##--######--##--######--##--#",
                "-##-###-#-############-#-###-##-",
                "##-###-#-##---####---##-#-###-##",
                "--#-###--#--#--##--#--#--###-#--",
                "-#-##--##------##------##--##-#-",
                "-----#--#-----#--#-----#--#-----",
                "--#-#-####---##--##---####-#-#--",
                "---#--#-######----######-#--#---",
                "----##--######-##-######--##----",
                "--------######-##-######--------",
                "--------#############-##--------",
                "--------#-#-##--##-#-###--------",
                "--------#-#-#-#-##-#---#--------",
                "----------#-#-#--#-#-#----------",
                "--------#-----#--#---#----------",
                "---------#----#--------#--------",
                "------------#--------#----------",
                "---------#--#-#----#------------",
                "----------#---#-#-----#---------",
                "------------#---#-#-#-----------",
                "-----------#-#-------#----------",
                "------------#-#-#--#------------",
                "---------------#-#--------------",
                "--------------------------------",
                "--------------------------------"
              ]
            ]
         }
      ]
   }
}