{
  "name":"West Bedroom",
  "shortName":"West Bedroom",
  "bkColor":"00",
  "borderColor":"05",
  "layout":[
    "00000400A0400000",
    "00000000A0400000",
    "00001000A0400000",
    "00000000A0400015",
    "00000400A0400000",
    "00000000A0400000",
    "00000010A0400000",
    "00000000A0400000",
    "0000040000400000",
    "0000000000400000",
    "0000100000400000",
    "0000080000400000",
    "0000095555555555",
    "00000AAAA0000000",
    "00000000A0000000",
    "00000000A0000000"
  ],
  "graphicData":{
    "floor":"06AA55824182418241",
    "wall":"0DA855A856CF2E26C1",
    "conveyors":[
      {
        "data":"42A5FFBDAA55BA4583",
        "moving":"left",
        "location":{
          "x":26,
          "y":3
        },
        "length":3
      }
    ]
  },
  "willy":{
    "init":{
      "x":240,
      "y":80,
      "direction":1,
      "frame":0
    }
  },
  "guardians":{
    "vertical":[
      {
        "figures":[
          {
            "attribute":"05",
            "limits":{
              "up":0,
              "down":64
            },
            "speed":2,
            "init":{
              "x":88,
              "y":32,
              "direction":1,
              "frame":0
            }
          }
        ],
        "width":16,
        "height":16,
        "paintCorrections":{
          "x":0,
          "y":0
        },
        "frames":4,
        "directions":2,
        "sprite":[
          [
            "----------------",
            "----------------",
            "----------------",
            "-##############-",
            "-#------------#-",
            "################",
            "##-####--####-##",
            "##------------##",
            "##------------##",
            "##-####--####-##",
            "################",
            "-#------------#-",
            "-##############-",
            "----------------",
            "----------------",
            "----------------"
          ],
          [
            "----#-#---------",
            "---###-#--------",
            "--##-##-#-------",
            "-##--###-#------",
            "##----###-#-----",
            "-###---###-#----",
            "#-###----##-#---",
            "-#-###----##-#--",
            "--#-##----###-#-",
            "---#-##----###-#",
            "----#-###---###-",
            "-----#-###----##",
            "------#-###--##-",
            "-------#-##-##--",
            "--------#-###---",
            "---------#-#----"
          ],
          [
            "-----######-----",
            "---##########---",
            "---#-#----#-#---",
            "---#-##--##-#---",
            "---#-##--##-#---",
            "---#-##--##-#---",
            "---#-##--##-#---",
            "---#-#----#-#---",
            "---#-#----#-#---",
            "---#-##--##-#---",
            "---#-##--##-#---",
            "---#-##--##-#---",
            "---#-##--##-#---",
            "---#-#----#-#---",
            "---##########---",
            "-----######-----"
          ],
          [
            "---------#-#----",
            "--------#-###---",
            "-------#-##-##--",
            "------#-###--##-",
            "-----#-###----##",
            "----#-###---###-",
            "---#-##----###-#",
            "--#-##----###-#-",
            "-#-###----##-#--",
            "#-###----##-#---",
            "-###---###-#----",
            "##----###-#-----",
            "-##--###-#------",
            "--##-##-#-------",
            "---###-#--------",
            "----#-#---------"
          ],
          [
            "----------------",
            "----------------",
            "----------------",
            "-##############-",
            "-#------------#-",
            "################",
            "##-####--####-##",
            "##------------##",
            "##------------##",
            "##-####--####-##",
            "################",
            "-#------------#-",
            "-##############-",
            "----------------",
            "----------------",
            "----------------"
          ],
          [
            "---------#-#----",
            "--------#-###---",
            "-------#-##-##--",
            "------#-###--##-",
            "-----#-###----##",
            "----#-###---###-",
            "---#-##----###-#",
            "--#-##----###-#-",
            "-#-###----##-#--",
            "#-###----##-#---",
            "-###---###-#----",
            "##----###-#-----",
            "-##--###-#------",
            "--##-##-#-------",
            "---###-#--------",
            "----#-#---------"
          ],
          [
            "-----######-----",
            "---##########---",
            "---#-#----#-#---",
            "---#-##--##-#---",
            "---#-##--##-#---",
            "---#-##--##-#---",
            "---#-##--##-#---",
            "---#-#----#-#---",
            "---#-#----#-#---",
            "---#-##--##-#---",
            "---#-##--##-#---",
            "---#-##--##-#---",
            "---#-##--##-#---",
            "---#-#----#-#---",
            "---##########---",
            "-----######-----"
          ],
          [
            "----#-#---------",
            "---###-#--------",
            "--##-##-#-------",
            "-##--###-#------",
            "##----###-#-----",
            "-###---###-#----",
            "#-###----##-#---",
            "-#-###----##-#--",
            "--#-##----###-#-",
            "---#-##----###-#",
            "----#-###---###-",
            "-----#-###----##",
            "------#-###--##-",
            "-------#-##-##--",
            "--------#-###---",
            "---------#-#----"
          ]
        ],
        "mapSprite":[
          "-#--",
          "###-",
          "-###",
          "--#-"
        ]
      },
      {
        "figures":[
          {
            "attribute":"42",
            "limits":{
              "up":0,
              "down":80
            },
            "speed":1,
            "init":{
              "x":112,
              "y":24,
              "direction":0,
              "frame":0
            }
          }
        ],
        "width":16,
        "height":16,
        "paintCorrections":{
          "x":0,
          "y":0
        },
        "frames":4,
        "directions":1,
        "sprite":[
          [
            "------##--------",
            "-----#--#-------",
            "-----#-###------",
            "----#-###-#-----",
            "---#-#-#-#------",
            "---#-###-##-----",
            "---#-###-##-----",
            "---########-----",
            "---#--###--#----",
            "--#-##-#-##-#---",
            "--#-####-####---",
            "--#-####-####---",
            "--#-####-####---",
            "--#-####-####---",
            "#-#-####-####--#",
            "-##############-"
          ],
          [
            "--------##------",
            "-------#--#-----",
            "-------#-###----",
            "------#-###-#---",
            "-----#-#-#-#----",
            "-----#-###-##---",
            "-----#-###-##---",
            "-----########---",
            "----#--###--#---",
            "---#-##-#-##-#--",
            "---#-####-####--",
            "---#-####-####--",
            "---#-####-####--",
            "---#-####-####--",
            "#--#-####-####-#",
            "-##############-"
          ],
          [
            "------##--------",
            "-----#--#-------",
            "-----#-###------",
            "----#-###-#-----",
            "---#-#-#-#------",
            "---#-###-##-----",
            "---#-###-##-----",
            "---########-----",
            "---#--###--#----",
            "--#-##-#-##-#---",
            "--#-####-####---",
            "--#-####-####---",
            "--#-####-####---",
            "--#-####-####---",
            "#-#-####-####--#",
            "-##############-"
          ],
          [
            "--------##------",
            "-------#--#-----",
            "-------#-###----",
            "------#-###-#---",
            "-----#-#-#-#----",
            "-----#-###-##---",
            "-----#-###-##---",
            "-----########---",
            "----#--###--#---",
            "---#-##-#-##-#--",
            "---#-####-####--",
            "---#-####-####--",
            "---#-####-####--",
            "---#-####-####--",
            "#--#-####-####-#",
            "-##############-"
          ]
        ],
        "mapSprite":[
          "-##-",
          "-##-",
          "####",
          "####"
        ]
      }
    ]
  }
}