{
  "name": "Orangery",
  "shortName": "Orangery",
  "bkColor": "00",
  "borderColor": "06",
  "layout": [
    "0000000000000000",
    "0000000000000000",
    "0000000000010000",
    "0000000000000000",
    "0000000000000000",
    "0000000040001000",
    "0000000000040040",
    "0000000000000000",
    "A000000400000000",
    "0000000001000000",
    "0020004000000500",
    "0025000040000055",
    "0020000000001000",
    "0020010000000000",
    "0020000000400000",
    "AAAA000140000000"
  ],
  "graphicData": {
    "floor": "04A54A240204000200",
    "wall": "161555552425554922",
    "item": "02142E552A452A14",
    "ramp": {
      "data": "050102040010204080",
      "gradient": "right",
      "location": {"x": 0, "y": 13},
       "length": "0E"
    },
    "conveyor": {
      "data": "26C6AAA82A59240000",
      "moving": "left",
      "location": {"x": 28, "y": 10},
       "length": "04"
    }
  },
  "adjoiningRoom": {
    "left": "38",
    "right": "24",
    "above": "2B",
    "below": "1F"
  },
   "guardians":{
      "vertical":[
         {
            "figures":[
               {
                  "attribute":"05",
                  "limits":{
                     "up":0,
                     "down":96
                  },
                  "speed":4,
                  "init":{
                     "x":160,
                     "y":32,
                     "direction":0,
                     "frame":0
                  }
               }
            ],
            "width":16,
            "height":16,
            "paintCorrections":{
               "x":0,
               "y":0
            },
            "frames":4,
            "directions":2,
            "sprite":[
              [
                "----########----",
                "---#-######-#---",
                "---##------##---",
                "--##-#####--##--",
                "--#-#-----#--#--",
                "-#-#--###--#--#-",
                "-##--#---#--#-#-",
                "#-#-#--#--#-#-##",
                "#-#-#-#---#-#-##",
                "-##-#-#--#--#-#-",
                "-##-#--##--#--#-",
                "--#--#----#--#--",
                "--##--####--##--",
                "---##------##---",
                "---#-######-#---",
                "----########----"
              ],
              [
                "--------###-----",
                "-----#######----",
                "--###------##---",
                "-###--####--##--",
                "-##--#----#--##-",
                "-#--#--##--#--##",
                "-#-#--#--#--#-##",
                "##-#-#----#-#-##",
                "##-#-#-#--#-#-#-",
                "##-#-#--##--#-#-",
                "##-#--#----#--#-",
                "-#--#--####--#--",
                "--#--#------##--",
                "---#--######-#--",
                "----#----####---",
                "-----####-------"
              ],
              [
                "-------##-------",
                "-----######-----",
                "---##------##---",
                "-###--####--###-",
                "#-#--#----#--#-#",
                "##--#--##--#-#-#",
                "##-#--#--#-#-#-#",
                "##-#-#---#-#-#-#",
                "##-#-#--#--#-#-#",
                "##-#--#---#--#-#",
                "##--#--###--#--#",
                "###--#-----#--##",
                "-###--#####--##-",
                "---##------##---",
                "-----######-----",
                "-------##-------"
              ],
              [
                "-----###--------",
                "----#---###-----",
                "---#######-###--",
                "--##------#--##-",
                "-##--####--#--#-",
                "##--#----#--#-#-",
                "##-#--##--#-#-#-",
                "##-#-#--#-#-#-##",
                "-#-#-#----#-#-##",
                "-#-#--#--#--#-##",
                "-#--#--##--#--##",
                "--#--#----#--##-",
                "--##--####--##--",
                "--#-#------##---",
                "---#########----",
                "-------####-----"
              ],
              [
                "----########----",
                "---#-######-#---",
                "---##------##---",
                "--##-#####--##--",
                "--#-#-----#--#--",
                "-#-#--###--#--#-",
                "-##--#---#--#-#-",
                "#-#-#--#--#-#-##",
                "#-#-#-#---#-#-##",
                "-##-#-#--#--#-#-",
                "-##-#--##--#--#-",
                "--#--#----#--#--",
                "--##--####--##--",
                "---##------##---",
                "---#-######-#---",
                "----########----"
              ],
              [
                "-----###--------",
                "----#---###-----",
                "---#######-###--",
                "--##------#--##-",
                "-##--####--#--#-",
                "##--#----#--#-#-",
                "##-#--##--#-#-#-",
                "##-#-#--#-#-#-##",
                "-#-#-#----#-#-##",
                "-#-#--#--#--#-##",
                "-#--#--##--#--##",
                "--#--#----#--##-",
                "--##--####--##--",
                "--#-#------##---",
                "---#########----",
                "-------####-----"
              ],
              [
                "-------##-------",
                "-----######-----",
                "---##------##---",
                "-###--####--###-",
                "#-#--#----#--#-#",
                "##--#--##--#-#-#",
                "##-#--#--#-#-#-#",
                "##-#-#---#-#-#-#",
                "##-#-#--#--#-#-#",
                "##-#--#---#--#-#",
                "##--#--###--#--#",
                "###--#-----#--##",
                "-###--#####--##-",
                "---##------##---",
                "-----######-----",
                "-------##-------"
              ],
              [
                "--------###-----",
                "-----#######----",
                "--###------##---",
                "-###--####--##--",
                "-##--#----#--##-",
                "-#--#--##--#--##",
                "-#-#--#--#--#-##",
                "##-#-#----#-#-##",
                "##-#-#-#--#-#-#-",
                "##-#-#--##--#-#-",
                "##-#--#----#--#-",
                "-#--#--####--#--",
                "--#--#------##--",
                "---#--######-#--",
                "----#----####---",
                "-----####-------"
              ]
            ]
         },
         {
            "figures":[
               {
                  "attribute":"42",
                  "limits":{
                     "up":64,
                     "down":104
                  },
                  "speed":2,
                  "init":{
                     "x":72,
                     "y":72,
                     "direction":1,
                     "frame":0
                  }
               }
            ],
            "width":16,
            "height":16,
            "paintCorrections":{
               "x":0,
               "y":0
            },
            "frames":4,
            "directions":1,
            "sprite":[
              [
                "------####------",
                "----###-####----",
                "---###-######---",
                "--#####-######--",
                "-#-#--####--###-",
                "-##--#-##-#--##-",
                "#-#--#----#--###",
                "-###---##---####",
                "#-##########-###",
                "-#-#-#-####-####",
                "-##-###--###-##-",
                "-#-#--####--#-#-",
                "--###------###--",
                "---#-##--####---",
                "----#-######----",
                "------#-##------"
              ],
              [
                "------####------",
                "----##-#####----",
                "---##-#-#####---",
                "--############--",
                "-#-#---##---##--",
                "-##--#----#--##-",
                "##---#-##-#--###",
                "#-##--####--####",
                "-#-###-##-###-##",
                "#-#-#-#--###-###",
                "-#-##########-#-",
                "-###--#--#--###-",
                "--###------###--",
                "---###----###---",
                "----#-######----",
                "------#-##------"
              ],
              [
                "------####------",
                "----#-######----",
                "---#-#-#-####---",
                "--############--",
                "-#-#--------##--",
                "-##--#-##-#--##-",
                "##---######--###",
                "####---##---####",
                "#-#####--#######",
                "##-###-#####-###",
                "--#-##----###-#-",
                "-#-##-#--#-####-",
                "--#-##----####--",
                "---#-##--####---",
                "----#-######----",
                "------####------"
              ],
              [
                "------####------",
                "----##-#####----",
                "---##-#-#####---",
                "--############--",
                "-#-#---##---##--",
                "-##--#----#--##-",
                "##---#-##-#--###",
                "#-##--####--####",
                "-#-###-##-###-##",
                "#-#-#-#--###-###",
                "-#-##########-#-",
                "-###--#--#--###-",
                "--###------###--",
                "---###----###---",
                "----#-######----",
                "------#-##------"
              ]
            ]
         }
      ],
      "arrow":[
         {
            "figures":[
               {
                  "attribute":"07",
                  "minCounter":0,
                  "maxCounter":255,
                  "soundWhenCounter":244,
                  "speed":8,
                  "init":{
                     "x":0,
                     "y":66,
                     "hide": true,
                     "counter":208,
                     "direction":0,
                     "frame":0
                  }
               }
            ],
            "width":8,
            "height":2,
            "paintCorrections":{
               "x":0,
               "y":-1
            },
            "frames":1,
            "directions":1,
            "sprite":[
              [
                "#-----#-",
                "########",
                "#-----#-"
              ]
            ]
         }
      ]
   }
}
